15TH	W AH N F AY V T IY EY CH
4TH	F OW R T IY EY CH
7TH	S EH V AH N T IY EY CH
</S>	EH S
<S>	EH S
A	AH
A(2)	EY
ABOUT	AH B AW T
AHEAD	AH HH EH D
AM	AE M
AM(2)	EY EH M
AND	AH N D
AND(2)	AE N D
ANY	EH N IY
ANYTHING	EH N IY TH IH NG
ARE	AA R
ARE(2)	ER
ASKING	AE S K IH NG
ASTER	AE S T ER
AT	AE T
AVENUE	AE V AH N UW
BACK	B AE K
BESIDES	B IH S AY D Z
BESIDES(2)	B IY S AY D Z
BOULEVARD	B UH L AH V AA R D
BRIGHTON	B R AY T AH N
BUSIER	B IH Z IY ER
BUSY	B IH Z IY
BYE	B AY
CONGESTED	K AH N JH EH S T AH D
CONGESTED(2)	K AH N JH EH S T IH D
COURT	K AO R T
DEARBORN	D IH R B AO R N
DO	D UW
EASIER	IY Z IY ER
EASIEST	IY Z IY AH S T
EASY	IY Z IY
ELMWOOD	EH L M W UH D
ELSE	EH L S
END	EH N D
FAST	F AE S T
FASTER	F AE S T ER
FASTEST	F AE S T AH S T
FORGET	F ER G EH T
FORGET(2)	F AO R G EH T
FREEWAY	F R IY W EY
FREEWAYS	F R IY W EY Z
GET	G EH T
GET(2)	G IH T
GO	G OW
GUESS	G EH S
GUINNESS	G IH N AH S
HIGHWAY	HH AY W EY
HIGHWAYS	HH AY W EY Z
HOW	HH AW
I	AY
INSANE	IH N S EY N
IS	IH Z
IT	IH T
LANE	L EY N
MC	M IH K
MC(2)	EH M S IY
MILL	M IH L
MORE	M AO R
MOST	M OW S T
MOST(2)	M OW S
NICE	N AY S
NICE(2)	N IY S
NICER	N AY S ER
NICEST	N AY S IH S T
NO	N OW
NOPE	N OW P
O	OW
OF	AH V
OKAY	OW K EY
OLD	OW L D
ON	AA N
ON(2)	AO N
ONE	W AH N
ONE(2)	HH W AH N
OTHER	AH DH ER
PAERDEGAT	P IY R D AH G AH T
PLACE	P L EY S
QUICK	K W IH K
QUICKER	K W IH K ER
QUICKEST	K W IH K IH S T
QUIT	K W IH T
RIDICULOUS	R IH D IH K Y AH L AH S
ROAD	R OW D
ROADS	R OW D Z
ROUGH	R AH F
ROUGHER	R AH F ER
ROUTE	R UW T
ROUTE(2)	R AW T
ROUTES	R UW T S
ROUTES(2)	R AW T S
ROUTES(3)	R UH T S
SKIDMORE	S K IH D M AO R
SLOW	S L OW
SLOWER	S L OW ER
SMOOTH	S M UW DH
SMOOTHER	S M UW DH ER
SMOOTHEST	S M UW DH AH S T
SOMETHING	S AH M TH IH NG
STOP	S T AA P
STREET	S T R IY T
STUPID	S T UW P AH D
STUPID(2)	S T UW P IH D
TERMINATE	T ER M AH N EY T
THAN	DH AE N
THAN(2)	DH AH N
THAT	DH AE T
THAT(2)	DH AH T
THE	DH AH
THE(2)	DH IY
THERE	DH EH R
THINK	TH IH NG K
THIS	DH IH S
TIME	T AY M
UHUH	AH HH UW
VERY	V EH R IY
WAY	W EY
WHAT	W AH T
WHAT(2)	HH W AH T
WHATEVER	W AH T EH V ER
WHATEVER(2)	HH W AH T EH V ER
WHICH	W IH CH
WHICH(2)	HH W IH CH
WHICHEVER	W IH CH EH V ER
WHICHEVER(2)	HH W IH CH EH V ER
YEAH	Y AE
YES	Y EH S
YOU	Y UW
